37123
111211111121
211212122121
211211121112
112111111111
211111121111
112111111111
112111211111
111112211111
111221121111
112111111211
211221211111
211211122111
212111111111
121111121211
112211121111
122111121111
111121111111
111212121111
211111111121
111111111111
122222112111
211111121111
212111111112
121221211212
112112121111
111121121111
112112211111
112211112111
121112211112
112111111121
111112121111
211111121111
111121111111
111112111121
111111221112
221111112111
112111111111
